111111111111111111111111111111111
111111111111111111111111111111111
11S100010001000100010001000100011
110101010101010101010101010101011
110101010101010101010101010101011
110101010101010101010101010101011
110001000100010001000100010001E11
111111111111111111111111111111111
111111111111111111111111111111111